F F F F F F V F F P F P	F F P C P P P P F P F F	F P F P F P F F F F E F	Q Q
F E F F F F F F P C P P	P P C C P P P P P P P P	P P P P P P P F P E F V	Q Q
E S E P F F F F C C P P	P P P P P P P P P P P P	P P P P P V P P F P E E	P F
E S O P F P P C D C P P	P V P P P P P P P P P P	P P P P P P P P P P P E	F F
E S O O F E P C C P P P	P P P P P P P P P P R P	P P P P P F P P P P F E	F F
E S S E E E E E P P P P	P P P P P P P P P P P P	P P P P P F F P P P E F	F P
E E E P F F P P E E E E	P P P D C P F F P P P P	P P P P P P P P P F E E	F F
P E C P V F P P P P P P	P E P C C P F F P F P P	P P P P P P P P P P F F	E F
E O E E P F F P F F P P	P E E P P P P P F P P P	P P P P P P P P P P F V	E M
E O O E P F F F F F P P	P E E E P E P P P S P P	P E P P P E P E E E P E	E P
E E E P P F P P F F F P	P V P P P E E E E E S P	E E E P E O E E E E E P	P P
E E E P V P P P F F P P	P P P P E S E O O O E P	E O O E P P E P E P P P	P F
P E P P P F P F P P P F	P P P F P S O S E E E P	E P E P E P P P P P V P	P F
P P E P F F F F P F P P	P P F F P P S P P P P F	P P P F P F P P P P P P	F F
P P E P P F F F F P P F	F F P F P P F P P P P F	P P P F F P P P P P P P	F P
P E E P F F F P F F Q F	F P F F P Q P F P Q F P	P P P F F P P P F P P P	P P
P p P F F F F P P Q F F	F F F F F P P F F F F P	P P P P P P P P P P P P	P P
P P E F F P F F P F F F	F P F F F F F F P F P P	P P P P P P P P P P V P	P P
P P E P P P P P P P F F	P P P P P P F F P Q P P	Q V P P P P P C C P P P	P P
Q E E Q P P P P P F F F	P P F Q P P Q P F Q P P	P P P P P P C D P C P P	P P
P M E Q C P P P P F F F	F F F Q Q F P P P F F F	P P P P P P C C C C P P	P P
Q P E P C C F F F F F F	P P F F Q Q P P Q Q P P	P P P P P P P P C P P V	P F
Q E E Q P P P Q Q P P P	F Q Q Q Q Q Q S S Q P P	Q Q P P P P P P P P P P	P F
M E M M Q P P Q Q P P P	P P P E E E E S Q Q Q P	P P P P P P P P P P P P	F F
M M E E M Q Q M M Q P Q	P Q J E E E E S S S Q Q	Q P P Q P P P P P P P P	F F
M M M E M M Q M M M M M	Q Q Q E E E P S V S M M	Q Q Q Q P P V P P P P P	P P
M E E M M M M M M M M M	M M E O O Q Q Q Q M M Q	F F F Q Q Q P P P P P P	P P
E O E E M M M M M M M O	E E E E E Q Q Q M M M Q	F Q F M Q M M Q Q F P P	P P
E O O E M M M M M M O O	E M M M M M M M M M M M	M M M M M M M M Q F F Q	P P
E O O O E E M M M O O O	M M M M M M M M M M M M	M M M M M M M M Q Q F F	F P
